999999999999999999999999999999999999999
999999999999999999999999999999999999999
999999999999999999999999999999999999999
999111111111111922222229000000000000999
999111111111111922222229000000000000999
999111111111111922222229000000000000999
999111111111111922222229000000000000999
999111111111111922222229000000000000999
999111111111111922222229000000000000999
999111111111111922222229000000000000999
999111111111111922222229000000000000999
999999999999999999999999999999999999999
999222222222222911111119333333333333999
999222222222222911111119333333333333999
999222222222222911111119333333333333999
999222222222222911111119333333333333999
999222222222222911111119333333333333999
999222222222222911111119333333333333999
999999999999999999999999999999999999999
999000000000000933333339000000000000999
999000000000000933333339000000000000999
999000000000000933333339000000000000999
999000000000000933333339000000000000999
999000000000000933333339000000000000999
999000000000000933333339000000000000999
999000000000000933333339000000000000999
999000000000000933333339000000000000999
999999999999999999999999999999999999999
999999999999999999999999999999999999999
999999999999999999999999999999999999999
Mon Jan 13 12:08:17 EST 2014
42 50 56 3