999999999999999999999999999999999999999
999999999999999999999999999999999999999
991111111111111111111119222222222222299
991111111111111111111119222222222222299
991111111111111111111119222222222222299
991111111111111111111119222222222222299
991111111111111111111119222222222222299
991111111111111111111119222222222222299
991111111111111111111119222222222222299
999999999999999999999999999999999999999
990000000000000000000000000000000000099
990000000000000000000000000000000000099
990000000000000000000000000000000000099
990000000000000000000000000000000000099
999999999900090009999999999999999999999
990000000000090000000000000000000000099
990000000000090000000000000000000000099
990000000000090000000000000000000000000
999999999999999999999999999999999999999
993333333392222222222222222222222222299
993333333392222222222222222222222222299
993333333392222222222222222222222222299
993333333399999999999999999999999999999
993333333390000000000000000093333333399
993333333390000000000000000093333333399
993333333390000000000000000093333333399
993333333390000000000000000093333333399
993333333390000000000000000093333333399
999999999999999999999999999999999999999
999999999999999999999999999999999999999
Sat Jan 11 18:40:48 EST 2014
80 90 40 4