009000990000000000000000000900000000000
009000990000000000000000000900000000000
009000990000000000000000000900000000000
009000990000000000000000000900000000000
009000990000000000000000000900000000000
999999999999999999999999999999999999999
009000992222222222222222222900000000000
009000992222222222222222222900000000000
009000992222222222222222222900000000000
009000992222222222222222222900000000000
009000992222222222222222222900000000000
009000992222222222222222222900000000000
009000992222222222222222222900000000000
009000992222222222222222222900000000000
009000992222222222222222222900000000000
009000992222222222222222222900000000000
009000992222222222222222222900000000000
009000992222222222222222222900000000000
999999999999999999999999999999999999999
999999999999999999999999999999999999999
009000990000000000000000000900000000000
009000990000000000000000000900000000000
009000990000000000000000000900000000000
009000990000000000000000000900000000000
009000990000000000000000000900000000000
999999999999999999999999999999999999999
009000990000000000000000000900000000000
009000990000000000000000000900000000000
009000990000000000000000000900000000000
009000990000000000000000000900000000000
Sat Jan 18 14:48:38 EST 2014
0 200 0 3