999999999999999999999999999999999999999
999999999999999999999999999999999999999
999999999999999999999999999999999999999
999000000000000000000000000000000000999
999000000000000000000000000000000000999
999000000000000000000000000000000000999
999000000000000000000000000000000000999
999000000000000000000000000000000000999
999000000000000000000000000000000000999
999000000000000000000000000000000000999
999000000000000000000000000000000000999
999000000000000000000000000000000000999
999000000000000000000000000000000000999
999000000000000000000000000000000000999
999000000999000000000000000000000000999
999000000919000000000000000000000000999
999000099999990000000000000000000000999
999000091919290000000000000000000000999
999000099999990000000000000000000000999
999000000939000000000000000000000000999
999000000999000000000000000000000000999
999000000000000000000000000000000000999
999000000000000000000000000000000000999
999000000000000000000000000000000000999
999000000000000000000000000000000000999
999000000000000000000000000000000000999
999000000000000000000000000000000000999
999999999999999999999999999999999999999
999999999999999999999999999999999999999
999999999999999999999999999999999999999
Sat Jan 11 17:16:38 EST 2014
1 1 1 3