999999999999999999999999999999999999999
999999999999999999999999999999999999999
992222222222229111111111111111111111199
992222222222229111111111111111111111199
992222222222229111111111111111111111199
992222222222229111111111111111111111199
992222222222229111111111111111111111199
992222222222229111111111111111111111199
992222222222229111111111111111111111199
992222222222229111111111111111111111199
092222222222229111111111111111111111199
092222222222229111111111111111111111199
092222222222229111111111111111111111199
092222222222229111111111111111111111199
092222222222229111111111111111111111199
092222222222229111111111111111111111199
999999999999999111111111111111111111199
993333333333339111111111111111111111199
993333333333339111111111111111111111199
993333333333339111111111111111111111199
993333333333339999999999999999999999999
993333333333339000000000000000000000099
993333333333339000000000000000000000099
993333333333339000000000000000000000099
993333333333339000000000000000000000099
993333333333339000000000000000000000099
993333333333339000000000000000000009999
993333333333339000000000000000000009399
999999999999999999999999999999999999999
999999999999999999999999999999999999999
Sat Jan 99 97:02:29 EST 2094
102 156 24 3