000000000000000090900000000000000000000
999999999999999999999999999999999999999
000000000000000092911111900000000000000
000000000000000092911111900000000000000
000000000000000092911111900000000000000
000000000000000092911111900000000000000
000000000000000092911111900000000000000
000000000000000092911111900000000000000
000000000000000092911111900000000000000
999999999999999999999999999999999999999
999999999999999999999999999999999999999
000000000000000091900000000000000000000
000000000000000091900000000000000000000
000000000000000091900000000000000000000
000000000000000091900000000000000000000
000000000000000091900000000000000000000
000000000000000091900000000000000000000
000000000000000091900000000000000000000
000000000000000091900000000000000000000
000000000000000091900000000000000000000
000000000000000091900000000000000000000
000000000000000091900000000000000000000
000000000000000091900000000000000000000
000000000000000091900000000000000000000
000000000000000091900000000000000000000
000000000000000091900000000000000000000
999999999999999999999999999999999999999
000000000000000093900000000000000000000
999999999999999999999999999999999999999
000000000000000090900000000000000000000
Sun Jan 19 11:05:25 EST 2014
30 7 1 4