000000000000000009111119900000000000000
000000000000000009999999900000000000000
000000000000000009000009900000000000000
000000000000000009111119900000000000000
000000000000000009111119900000000000000
000000000000000009111119900000000000000
000000000000000009111119900000000000000
999999999999999999999999999999999999999
000000000000000009222229900000000000000
000000000000000009222229900000000000000
000000000000000009222229900000000000000
000000000000000009222229900000000000000
000000000000000009222229900000000000000
000000000000000009222229900000000000000
000000000000000009222229900000000000000
000000000000000009222229900000000000000
000000000000000009222229900000000000000
000000000000000009222229900000000000000
000000000000000009222229900000000000000
000000000000000009222229900000000000000
000000000000000009222229900000000000000
000000000000000009222229900000000000000
000000000000000009222229900000000000000
000000000000000009222229900000000000000
000000000000000009999999999999999999999
000000000000000009333339900000000000000
000000000000000009333339900000000000000
000000000000000009333339900000000000000
000000000000000009333339900000000000000
000000000000000009333339900000000000000
Sat Jan 18 15:39:32 EST 2014
21 80 25 4