000000000000000000000090090000000000000
000000000000000000000090090000000000000
000000000000000000000090090000000000000
999999999999999999999999999999999999999
000000000000922222222290090000000000000
000000000000922222222290090000000000000
000000000000922222222290090000000000000
999999999999999999999999999999999999999
000000000000000000000933390000000000000
000000000000000000000933390000000000000
000000000000000000000933390000000000000
000000000000000000000933390000000000000
000000000000000000000933390000000000000
999999999999999999999999999999999999999
000000000000000000000090090000000000000
000000000000000000000090090000000000000
000000000000000000000090090000000000000
000000000000000000000090090000000000000
000000000000000000000090090000000000000
000000000000000000000090090000000000000
000000000000000000000090090000000000000
000000000000000000000090090000000000000
000000000000000000000090090000000000000
000000000000000000000090090000000000000
999999999999999999999999999999999999999
000000000000000000000090090000000000000
000000000000000000000090090000000000000
000000000000000000000090090000000000000
000000000000000000000090090000000000000
000000000000000000000090090000000000000
Sun Jan 19 10:58:35 EST 2014
0 20 15 3