999999999999999999999999999999999999999
000000000000091111111900000000000000000
000000000000091111111900000000000000000
000000000000091111111900000000000000000
000000000000091111111900000000000000000
000000000000091111111900000000000000000
999999999999999999999999999999999999999
000000000000092222933900000000000000000
000000000000092222933900000000000000000
000000000000092222933900000000000000000
000000000000092222933900000000000000000
000000000000092222933900000000000000000
000000000000092222933900000000000000000
000000000000092222933900000000000000000
999999999999999999999999999999999999999
000000000000093333900900000000000000000
000000000000093333900900000000000000000
000000000000093333900900000000000000000
000000000000093333900900000000000000000
000000000000093333900900000000000000000
000000000000093333900900000000000000000
000000000000093333900900000000000000000
000000000000093333900900000000000000000
000000000000093333900900000000000000000
999999999999999999999999999999999999999
000000000000090000900900000000000000000
000000000000090000900900000000000000000
000000000000090000900900000000000000000
000000000000090000900900000000000000000
000000000000090000900900000000000000000
Sun Jan 19 11:02:22 EST 2014
25 25 30 3