999999999999999999999999999999999999999
922922222222222222222900000000000000009
922922222222222222222900000000000000009
922999999999999999999900000000000000009
922911111111111111111900000000000000009
922911111111111111111900000000000000009
922911111111111111111900000000000000009
922911111111111111111900000000000000009
922911111111111111111900000000000000009
922911111111111111111900000000000000009
922911111111111111111999999999999999999
922911111111111111111933333333333333339
922911111111111111111933333333333333339
999999999999999999999933333333333333339
900922222222222222222933333333333333339
900922222222222222222933333333333333339
900922222222222222222933333333333333339
900922222222222222222933333333333333339
900922222222222222222933333333333333339
900922222222222222222933333333333333339
900922222222222222222933333333333333339
900922222222222222222933333333333333339
900922222222222222222933333333333333339
900922222222222222222933333333333333339
900922222222222222222933333333333333339
900922222222222222222933333333333333339
900922222222222222222933333333333333339
900922222222222222222933333333333333339
900922222222222222222933333333333333339
999999999999999999999999999999999999999
Sat Jan 18 15:06:56 EST 2014
90 200 200 3