000000009000000000090000000000000000000
000000009000000000090000000000000000000
000000009000000000090000000000000000000
000000009000000000090000000000000000000
000000009000000000090000000000000000000
000000009000000000090000000000000000000
000000009000000000090000000000000000000
000000009000000000090000000000000000000
000000009000000000090000000000000000000
000000009000000000090000000000000000000
000000009000000000090000000000000000000
000000009000000000090000000000000000000
999999999999999999999999999999999999999
000000009111111111190000000000000000000
000000009111111111190000000000000000000
000000009111111111190000000000000000000
000000009111111111190000000000000000000
000000009111111111190000000000000000000
000000009111111111190000000000000000000
999999999999999999999999999999999999999
000000009000000000090000000000000000000
000000009000000000090000000000000000000
000000009000000000090000000000000000000
000000009000000000090000000000000000000
000000009000000000090000000000000000000
000000009000000000090000000000000000000
000000009000000000090000000000000000000
000000009000000000090000000000000000000
000000009000000000090000000000000000000
000000009000000000090000000000000000000
Sun Jan 19 10:39:27 EST 2014
56 0 0 4