000000000000000000000000000000000000000
000000000990999999999999999999990000000
000000000991111111111111111111990000000
000000000099111111111111111119900000000
000000000009911111111111111199000000000
000000000000991111111111111990000000000
000000000000099111111111119900000000000
000000000000009911111111199000000000000
000000000000000991111111990000000000000
000000000000000099111119900000000000000
000000000000000009911199000000000000000
000000000000000000999990000000000000000
000000000000000000090900000000000000000
000000000000000000090900000000000000000
000000000000000000090900000000000000000
009999999999000000090999999999999999900
009222222229000000090000000933333333900
009222222229000000090999999933333333900
009222222229000000090900000933333333900
009222222229000000090900000933333333900
009222222229000000090900000933333333900
009222222229000000090900000933333333900
009222222229999999990900000933333333900
009222222229000000000900000933333333900
009999999999999999990900000999999999900
000000000000000000090900000000000000000
000000000000000000099900000000000000000
000000000000000000093900000000000000000
000000000000000000099900000000000000000
000000000000000000000000000000000000000
Sat Jan 11 16:47:22 EST 2014
60 64 65 4