999999999999999999900000000000000000000
900092222222222900900000000000000000000
900092222222222900900000000000000000000
900092222222222900900000000000000000000
900092222222222900900000000000000000000
900092222222222900900000000000000000000
900092222222222900900000000000000000000
900099999999999900900000000000000000000
909000000000000000900000000000000000000
909000000000000000900000000000000000000
909000000000000000900000000000000000000
909999990999999999900000000000000000000
900090000000009000900000000000000000000
900090000000009000900000000000000000000
900090000000099000900000000000000000000
900099999999090000900000000000000000000
900000000000090000900000000000000000000
990000000000090000900000000000000000000
099000009999990000900000000000000000000
009900000000000000900000000000000000000
000999990999999999900000000000000000000
000000000000000000000000000000000000000
000000000000000000000000000000000000000
000000000000000000000000000000000000000
000000000000000000000000000000000000000
000000000000000000000000000000000000000
000000000000000000000000000000000000000
000000000000000000000000000000000000000
000000000000000000000000000000000000000
000000000000000000000000000000000000000
Sat Jan 18 18:42:08 EST 2014
0 60 0 1