999999999099999999909999999999999999999
991111111111111119909922222222222222299
099111111111111199000992222222222222990
009911111111111990000099222222222229900
000091111111119900000009922222222299000
000099111111199000000000992222222990000
000009911111990000000000099222229900000
000000991119900000000000009922299000000
000000099199000000000000000992990000000
000000009990000000000000000099900000000
000000099399000000000000000993990000000
000000993339900000000000009933399000000
000009933333990000000000099333339900000
000099333333399000000000993333333990000
000993333333339900000009933333333399000
009933333333333990000099333333333339900
099333333333333399000993333333333333990
993333333333333339909933333333333333399
999999999999999999909999999990999999999
000000000000000000000000000000000000000
000000000000000000000000000000000000000
000000000000000000000000000000000000000
000000000000000000000000000000000000000
000000000000000000000000000000000000000
000000000000000000000000000000000000000
000000000000000000000000000000000000000
000000000000000000000000000000000000000
000000000000000000000000000000000000000
000000000000000000000000000000000000000
000000000000000000000000000000000000000
Sat Jan 18 18:25:13 EST 2014
64 64 128 2