000000000000000000000000000000000000000
000000090000000000000000000000000000000
090000009000000000000000000090000000090
000000000000090009000000900000000000000
000000900000000000000000000000009000000
000000000000000000000000000000900000000
000900000009009000900000090000000000000
000000000000000000000090000000000000900
000000090000000900009000000090090090000
000000000000090000000000000000000000000
000000000900000009000009000009000000000
000000000000000000000000000000090000000
000000000000000000000000000000000000000
000000900009000900900000090000000000000
000000000000000000090000009090000090000
000000000000000000000000000000000000000
000000000000000090000090000000009000000
000000000000900000000000000000000000000
000000000000000000009000090090000000000
000000000000000900000090000000000090000
000000000000000009000000000000000000000
000000000000000000090000009000000000000
000000000000000000000000000000000000000
000000000000999999909999999990000000000
000000000000999999999999999990000000000
000000000000933333333333333390000000000
000000000000933333333333333390000000000
000000000000933333333333333390000000000
000000000000999999999999999990000000000
000000000000000000000000000000000000000
Sat Jan 18 18:15:55 EST 2014
0 0 45 1