999999999999999999999999999000000000000
099111111111111111111111990000000000000
009911111111111111111119900000000000000
000991111111111111111199000000000000000
000099111111111111111990000000000000000
000009911111111111119900000000000000000
000000991111111111199000000000000000000
000000099111111111990000000000000000000
000000009911111119900000000000000000000
000000000991111199000000000000000000000
000000000099111990000000000000000000000
000000000009919900000000000000000000000
000000099999999999990000000000000000000
000000092222222222290000000000000000000
000000092222222222290000000000000000000
000000092222222222290000000000000000000
000000092222222222290000000000000000000
000000092222222222290000000000000000000
000000092222222222290000000000000000000
000000092222222222290000000000000000000
000000092222222222290000000000000000000
000000092222222222290000000000000000000
000000092222222222290000000000000000000
000000092222222222290000000000000000000
000000092222222222290000000000000000000
000000092222222222290000000000000000000
000000099999999999990000000000000000000
000000000000000000000000000000000000000
000000000000000000000000000000000000000
000000000000000000000000000000000000000
Sat Jan 18 18:40:02 EST 2014
0 64 0 1